day_id,close
D3660400,1
D3660800,1
D3661200,1
D3661600,1
D3662000,1
D3670000,1
